######################################################################
#              #                                                         
#              #                                                         
#####      #####                                                          
#              #                          #      #####################
#              #                          #                          #                                               
#              #                          #                          #
#              #                          #                          #
#              #############      ############################      ##
#              #                          #                          #
#              #                          #                          #
#              #                          #                          #
######     #####                          #                          #
                                          #      #####################
                                          #                          #
                                          #                          #
                                          #                          #
                                          #                          #
##########      ####################      ####################       #
#        #      #                         #                          #
#        #      #                         #                          #
#        #      #                         #                          #
#               ######################################################
#                             #      #        #      #         #     #
#                                                                    #
#        #                                                           #
#        #                                                           #
#        #                    #      #        #      #         #     #
#        #                    #      #        #      #         #     #
######################################################################

