@@@@@@@@@@@@@@@@@@@@@@@@@@@@@@@@@@@@@@@@@@@@@@@@@@@@@
@                                                   @
@                                                   @
@                                                   @
@                                                   @
@                                                   @
@                                                   @
@                                                   @
@                                                   @
@                                                   @
@                                                   @
@                           @@@@@@@@@@@@@@@@@@@@@@@@@
@                                                   @
@@@@@@@@@@@@@@@@@@@@@@@@@@@@@@@@@@@@@@@@@@@@@@@@@@@@@

